XXXXXXXXXXXXXXXXXXXXXXXXXXXXXX
XP O O O O O O O O O O O O OX
X O XXXXX O XXXXX O XXXXX O X
X O X   X O X   X O X   X O X
X O XXXXX O XXXXX O XXXXX O X
X O O O O O O O O O O O O O X
X O XXXXX O XXXXX O XXXXX O X
X O X   X O X   X O X   X O X
X O XXXXX O XXXXX O XXXXX O X
X O O O O O O * O O O O O O X
X O XXXXX O XXXXX O XXXXX O X
X O X   X O X A X O X   X O X
X O XXXXX O XBCXX O XXXXX O X
X O O O O O X D X O O O O O X
X O XXXXX O XXXXX O XXXXX O X
X O X   X O X   X O X   X O X
X O XXXXX O XXXXX O XXXXX O X
X * O O O O O O O O O O O * X
X O XXXXX O XXXXX O XXXXX O X
XXXXXXXXXXXXXXXXXXXXXXXXXXXXXX
