XXXXXXXXXX
XOOOOOOOOX
XOOOOOOAOX
XOOXXXXOOX
XOOCOPXOOX
XOOODO*BOX
XOOXXXXOOX
XOOOOOOOOX
XOOOOOOOOX
XXXXXXXXXX
